********************
* *                *
* * ** ** ****** ***
*    ***  *      * *
* *****  **  ***** *
*     ****  *****  *
***** *  ** ***** **
*      * **  **    *
* **** * *** *   * *
*  **  *  *    * * *
* * * ***** * *  * *
* * *  *  *  ** ****
* *  *  * ***   ** *
*    *  *          *
********************