********************
*E*                *
* * ** ** ****** ***
*    ***  *      * *
* *****  **  ***** *
*     ****  *****  *
***** *  ** ***** **
*      * **  **    *
* **** * *** *   * *
*  **  *  *    * * *
* * * ***** * *  * *
* * *  *  *  ** ****
* *  *  * ***   ** S
*    *  *          *
********************