********************
*E*                *
* * ** ** ****** ***
*    ***  *      * *
* *****  TT  TT*** *
*     **TT  TTTT*  *
***** *  TT TTT** **
*      * *T  T*    *
* **** * *TT T   * *
*  **  *  *    * * *
* * * ***** * *  * *
* * *  *  *  ** ****
* *  *  * ***   ** S
*    *  *          *
********************